9       9
#########
#       #
#       #
#       #
#       #
#       #
# *     #
#       #
#########
