15  15
###############
#             #
#             #
#             #
#             #
#             #
#             #
#      *      #
#             #
#             #
#             #
#             #
#             #
#             #
###############
