9 9
#########
# #     #
##      #
#       #
#       #
#       #
# *     #
#       #
#########
