15 22
#####............#####
#   #............#   #
#   ##############   #
#                    #
#     ##### ######   #
#     ##### ##       #
# *   ##### ## ###   #
#     ##### ## ###   #
#     #####    ###   #
#     ############   #
####       #         #
....#      #     ### #
.....#          ###  #
......#####     #    #
...........###########
