9 9
#########
#       #
#   #   #
#   #   #
#   #   #
#   #   #
#     * #
#       #
#########
