7 6
######
#   ##
#*# ##
#   ##
## ###
#    #
######
