50                                              50
##################################################
#                                                #
#  ############### ##########################    #
#  #                                        #    #                                             
#  #    ############## #################    #    #                                   
#  #    #                              #    #    #                                             
#  #    #                              #    #    #                                           
#  #    #                              #    #    #                 
#  #    #   #           #        #     #    #    #                                               
#  #    #   #           #        #     #    #    #                                              
#  #    #   #           #        #     #    #    #
#  #    #   #           #        #     #    #    #
#  #    #   #           #        #     #    #    #
#  #    #   #          #        #       #   #    #
#  #    #   #           #        #     #    #    #
#  #    #   #           #        #     #    #    #
#  #    #   #           #        #     #    #    #
#  #    #   #           #        #     #    #    #
#  #    #   #           #        #     #    #    #
#  #    #   #           #        #     #    #    #
#  #    #   #          *#        #     #    #    #
#  #    #   #           #        #     #    #    #
#  #    #   #           #        #     #    #    #
#  #    #   #           #        #     #    #    #
#  #    #   #           #        #     #    #    #
#  #    #   #           #        #     #    #    #
#  #        #           #        #          #    #
#  #    #   #           #        #     #    #    #
#  #    #   #           #        #     #    #    #
#  #    #   #          #        #      #    #    #
#  #    #   #           #        #     #    #    #
#  #    #   #           #        #     #    #    #
#  #    #   #           #        #     #    #    #
#       #   #           #        #     #    #    #                                              
#  #    #   #           #        #     #    #    #                                              
#  #    #   #           #        #     #    #    #                                              
#  #    #   #           #        #     #         #                                              
#  #    #   #           #        #     #    #    #                                              
#  #    #   #           #        #     #    #    #                                              
#  #    #                              #    #    #                                              
#  #    #                              #    #    #                                              
#  #    #                              #    #    #                                              
#  #    #                              #    #    #                                              
#  #    ############## #################    #    #
#  #                                        #    #
#  ######################## #################    #
#                                                #
#                                                #
#                                                #
##################################################
